Дуров	Информатика
Владимирова	Физика
Перекопский	Физика
Дуров	Информатика
Кобылянский	Информатика
Сепиашвили	Математика
Васильева	Информатика
Кузнецов	Информатика
Петров	Информатика
Джумасултанова	Информатика
Городецкий	Физика
Васильков	Информатика
Беспалова	Информатика
Беспалов	Информатика
Кречмер	Информатика
Аленький	Информатика
Турпиашвили	Информатика
Равдоникас	Информатика
Воронин	Информатика
Столбовский	Информатика
Цицуашвили	Математика
Ведущенко	Информатика
Семиколенова	Информатика
Плуталова	Физика
Смирнов	Информатика
Казекин	Информатика
Чередников	Информатика
Миллер	Информатика
Маркин	Информатика
Турпиашвили	Математика
Мирилашвили	Информатика
Виноградов	Математика
Лесохин	Информатика
Шалел	Информатика
Мороз	Информатика
Морозова	Информатика
Вознесенский	Информатика
Фуртикова	Физика
Смирнов	Информатика
Чернышев	Физика
Владимиров	Математика
Ковалев	Информатика
Желудкова	Информатика
Розенберг	Информатика
Конрадт	Информатика
Ланина	Информатика
Поликарпов	Информатика
Мирилашвили	Информатика
Миронов	Физика
Романченко	Математика
Лебедева	Информатика
Филимонова	Информатика
Копылова	Физика
Аксёнова	Информатика
Спектер	Информатика
Куценко	Математика
Кукулиева	Информатика
Медведев	Информатика
Пиастро	Информатика
Калинина	Физика
Олейник	Физика
Белинская	Информатика
Забоева	Информатика
Теплова	Математика
Брагина	Информатика
Дочева	Информатика
Меньшикова	Физика
Ребикова	Информатика
Пономаренко	Физика
Курбатова	Физика
Горюнова	Физика
Лаврова	Информатика
Алексеева	Информатика
Умнов	Информатика
Краснов	Информатика
Никулина	Информатика
Соколова	Информатика
Сторчевая	Математика
Игошина	Информатика
Горбунова	Математика
Картошкин	Физика
Харчев	Информатика
Шаптай	Информатика
Филатова	Информатика
Рощин	Физика
Михайлов	Информатика
Зайцева	Математика
Левиев	Физика
Муромцева	Информатика
Абанин	Информатика
Орлов	Информатика
Левиева	Математика
Погорелый	Информатика
Юнаева	Физика
Замахов	Информатика
Федорова	Физика
Сергеевич	Физика
Кондратова	Информатика
Аленичева	Информатика
Романько	Информатика
Ткаченко	Информатика
Романько	Математика
Коменденко	Информатика
Кириленко	Математика
Кириленко	Физика
Усманова	Информатика
Алхазова	Математика
Бирарова	Информатика
Городецкий	Информатика
Чепурная	Информатика
Цывьян	Математика
Захаренков	Информатика
Смирнов	Физика
Смирнова	Физика
Безносова	Информатика
Егоров	Информатика
Корнев	Информатика
Андреев	Информатика
Кретова	Информатика
Владимирова	Физика
Рожинский	Информатика
Савинкина-Титова	Информатика
Граммаков	Информатика
Лыков	Физика
Лежнева	Информатика
Колосов	Информатика
Михасев	Информатика
Макура	Информатика
Кораблев-Дайсон	Информатика
Гребнев	Информатика
Келим	Физика
Караваева	Информатика
Бондаренко	Информатика
Киршнер	Информатика
Парсонс	Математика
Стрельников	Информатика
Дьяков	Информатика
Ластовка	Информатика
Барабанова	Математика
Скрябина	Физика
Ямщикова	Информатика
Скрелин	Информатика
Гриценко	Информатика
Дьячкова	Математика
Дормидонтова	Информатика
Смирнов	Математика
Фёдорова	Информатика
Казанский	Информатика
Зелёный	Информатика
Кудряшова	Информатика
Конашенок	Математика
Акамёлков	Информатика
Соловьев	Физика
Курчакова	Информатика
Ступина	Информатика
Гладущик	Физика
Кирсанова	Физика
Петропавловская	Информатика
Нестеров	Информатика
Лазо	Информатика
Мартиросов	Информатика
Исаев	Информатика
Дигина	Информатика
Бычков	Информатика
Дрожжин	Математика
Баранова	Информатика
Глейм	Физика
Булгаков	Информатика
Насекина	Математика
Журавлёв	Информатика
Тимофеева	Информатика
Степанова	Информатика
Коробейников	Информатика
Власова	Информатика
Скобейко	Информатика
Колдунова	Информатика
Пасуманский	Информатика
Гордеева	Математика
Рейнгольд	Информатика
Карпова	Математика
Бабаин	Информатика
Чудотворов	Информатика
Микушев	Информатика
Щёголь	Информатика
Уласень	Информатика
Резуник	Информатика
Дьякова	Математика
Ватолин	Физика
Костина	Математика
Графова	Физика
Чубей	Информатика
Пугачёва	Физика
Гвоздева	Информатика
Захаров	Информатика
Бердникова	Математика
Суворов	Информатика
Филоненко	Информатика
Рыбакова	Информатика
Селиванов	Математика
Моржов	Информатика
Самойлов	Физика
Тюрина	Физика
Михайлова	Информатика
Коровникова	Информатика
Кузнецов	Информатика
Грей	Информатика
Волкова	Информатика
Семенова	Физика
Иванова	Информатика
Цимберг	Информатика
Андриенко	Математика
Дряхлова	Физика
Столовицкая	Информатика
Дмитриева	Информатика
Кондаков	Информатика
Покровский	Информатика
Суртаева	Информатика
Гуманюк	Математика
Танчак	Информатика
Чупира	Информатика
Жеребкова	Физика
Учагина-Василенок	Информатика
Вязьменская	Информатика
Сюткин	Информатика
Скоробогатько	Информатика
Вишневская	Информатика
Новичков	Физика
Явдощук	Физика
Биргер	Физика
Ласкателева	Математика
Малашевская	Информатика
Логачев	Информатика
Титова	Математика
Степанов	Информатика
Иванов	Физика
Кукушкин	Информатика
Шипов	Информатика
Прядченко	Информатика
Медведев	Информатика
Лесохина	Информатика
Сомкина	Информатика
Бабинская	Информатика
Васильева	Информатика
Гершон	Физика
Соколенко	Информатика
Орлов	Информатика
Логинова	Информатика
Желтов	Информатика
Яроцкая	Математика
Левина	Информатика
Гончаренко	Информатика
Чернецкий	Математика
Байбагышев	Информатика
Иванов	Информатика
Богуш	Информатика
Никельс	Информатика
Залётов	Информатика
Бурмак	Информатика
Витальев	Информатика
Пилин	Информатика
Фоминых	Информатика
Фролова	Информатика
Барабанова	Информатика
Бойко	Математика
Румянцева	Информатика
Силюкова	Информатика
Таразевич	Информатика
Харламова	Информатика
Казакова	Информатика
Овчинникова	Информатика
Бацманова	Математика
Ускова	Математика
Григорович	Математика
Фейн	Физика
Мамонтова	Информатика
Кухта	Информатика
Вилинбахова	Информатика
Кудинова-Ли	Физика
Александрович	Информатика
Васильева	Информатика
Кириков	Информатика
Коротков	Информатика
Веселова	Информатика
Пертусян	Информатика
Семченкова	Информатика
Кильдиярова	Информатика
Порошина	Информатика
Коваленко	Информатика
Назаренко	Информатика
Козобродов	Информатика
Маркитантова	Информатика
Белая	Информатика
Константинова	Физика
Сергеева	Информатика
Сираканян	Математика
Шульман	Информатика
Славов	Физика
Богданов	Информатика
Супрычева	Информатика
Алексеевская	Информатика
Бурцев	Информатика
Кочнев	Информатика
Титов	Информатика
Щукин	Информатика
Давыденко	Информатика
Поляк	Физика
Королев	Информатика
Веткина	Физика
Николаев	Информатика
Шарко	Информатика
Железнов	Математика
Якунчикова	Информатика
Еременко	Физика
Жаржавская	Физика
Эрние	Информатика
Воронцов	Информатика
Телегина	Информатика
Иванова	Информатика
Пахомов	Информатика
Кармов	Информатика
Скрипка	Информатика
Войтенко	Физика
Коновалова	Информатика
Матвейчук	Математика
Кирпичников	Физика
Зубков	Информатика
Ажинова	Информатика
Новикова	Физика
Пермякова	Информатика
Золотонос	Информатика
Субботин	Информатика
Дюжев	Информатика
Шипилов	Информатика
Стороженко	Информатика
Нигматуллина	Математика
Леонтьева	Информатика
Юрецкий	Информатика
Иванов	Информатика
Рамбов	Информатика
Богданов	Информатика
Михайлович	Информатика
Гуляев	Информатика
Требина	Информатика
Грюнвальд	Информатика
Желтянников	Математика
Гаген-Торн	Математика
Шехтер	Информатика
Баранов	Информатика
Нагапетян	Информатика
Апророо	Информатика
Захарова	Физика
Перекопский	Информатика
Вознесенский	Информатика
Пушкина	Информатика
Зайцев	Информатика
Никончук	Информатика
Самкина	Математика
Тайлер	Информатика
Самуйлова	Информатика
Комаров	Информатика
Мошков	Информатика
Стацевич	Математика
Чебанова	Физика
Васильева	Информатика
Нураева	Информатика
Юрасова	Информатика
Каткова	Информатика
Леонидович	Информатика
Родионова	Информатика
Ящике	Информатика
Ширяев	Физика
Монихарт	Математика
Бабурова	Информатика
Кадобнов	Физика
Малыгин	Информатика
Лапина	Математика
Егорова	Математика
Шикова	Информатика
Амбалов	Информатика
Резинкина	Информатика
Чугунов	Информатика
Рябкова	Информатика
Новиков	Информатика
Илатовская	Математика
Вершинина	Информатика
Карпенко	Информатика
Людей	Информатика
Деметрадзе	Информатика
Федоренко	Информатика
Крамарь	Информатика
Ковалёв	Информатика
Гайдуль	Информатика
Индиенко	Физика
Антилюдовик	Информатика
Ершова	Физика
Карева	Математика
Борисович	Информатика
Хохлова	Информатика
Корягин	Информатика
Джанашвили	Информатика
Осипова	Информатика
Земских	Информатика
Шильниковская	Информатика
Некрасова	Информатика
Пенькин	Информатика
Мамаев	Информатика
Насилова	Информатика
Прямицына	Информатика
Миронова	Информатика
Сухачева	Информатика
Орлова	Физика
Черняк	Информатика
Михайлович	Математика
Крохмаль	Математика
Болтин	Информатика
Цехмейстер	Информатика
Бороздин	Информатика
Куля	Информатика
Ксензов	Физика
Попугаев	Информатика
Федосина	Информатика
Оленников	Физика
Бакаев	Информатика
Россошанский	Физика
Розовская	Физика
Куликов	Физика
Вершкова	Информатика
Сорочкин	Информатика
Квон	Информатика
Чащина	Информатика
Баранов	Информатика
Иванов	Информатика
Сычев	Физика
Литвиненко	Информатика
Тарарышкина	Информатика
Захаров	Информатика
Сорокина	Информатика
Мамагина	Математика
Балдычева	Информатика
Гулай	Информатика
Суслова	Информатика
Рассказова	Физика
Любимкина	Математика
Мордовина	Информатика
Баев	Информатика
Палькина-Шибкова	Математика
Остапенко	Физика
Павлов	Информатика
Журавлев	Физика
Симоненко	Физика
Лосева	Информатика
Бровина	Информатика
Руднев	Информатика
Калинин	Информатика
Иванов	Информатика
Крикливый	Информатика
Удодова	Математика
Богатов	Информатика
Васильев	Информатика
Шейкин	Информатика
Бахтина	Математика
Ярось	Информатика
Забирова	Информатика
Колесников	Математика
Гущина	Информатика
Беляков	Информатика
Баскаков	Математика
Абраменко	Информатика
Телегова	Информатика
Исавнин	Информатика
Кондратьева	Информатика
Слабковская	Информатика
Ефанов	Информатика
Александрова	Информатика
Баинов	Информатика
Пыльнева	Информатика
Кальней	Математика
Шпаковский	Информатика
Беляев	Информатика
Соловьёва	Информатика
Берг	Информатика
Кудрина	Физика
Дубровин	Информатика
Верюжская	Информатика
Горбецкая	Информатика
Луговский	Информатика
Ефремов	Информатика
Витько	Информатика
Пашковская	Информатика
Гуторина	Информатика
Антонова	Информатика
Кирилюк	Информатика
Шоман	Математика
Галибов	Информатика
Череватенко	Информатика
Юшкевич	Информатика
Алексеев	Математика
Крылова	Физика
Аксельрод	Математика
Шумейко	Информатика
Великохатная	Математика
Блинохватов	Информатика
Шевцов	Информатика
Свавильная	Информатика
Круглов	Информатика
Смирнова	Информатика
Матушкин	Информатика
Якимов	Математика
Омелина	Информатика
Жуленев	Информатика
Боев	Информатика
Духин	Информатика
Семёнова	Информатика
Яцко	Физика
Мурашкина	Информатика
Парамонова	Информатика
Каманов	Математика
Кушнаренко	Информатика
Овсянников	Информатика
Петров	Информатика
Баскова	Информатика
Кулик	Информатика
Марков	Физика
Шарко	Информатика
Пономаренко	Физика
Белоус	Информатика
Гайдабура	Физика
Корото	Информатика
Дмитриев	Физика
Раков	Информатика
Кучук	Физика
Федорова	Математика
Каширина	Физика
Ахмерова	Математика
Атлас	Информатика
Головкин	Физика
Калинин	Информатика
Анисимова	Информатика
Ксенофонтова	Информатика
Буханцев	Информатика
Ильина	Физика
Уткин	Информатика
Лазарев	Информатика
Туляганов	Физика
Тимофеева	Физика
Коссаковский	Информатика
Кронидов	Информатика
Лесин	Физика
Зойдберг	Математика
Котов	Информатика
Полосова	Информатика
Сысоева	Математика
Забродин	Математика
Петошин	Информатика
Епихов	Информатика
Кремнев	Информатика
Шведкина	Информатика
Веселов	Физика
Боричев	Информатика
Баранова	Информатика
Москони	Информатика
Гречухина	Физика
Зайцева	Информатика
Чайко	Математика
Тигрулин	Информатика
Бирюков	Информатика
Кибальчук	Информатика
Сазонова	Информатика
Батманов	Информатика
Александрович	Информатика
Евграфов	Информатика
Токмаков	Информатика
Ямаков	Информатика
Бобкина	Информатика
Истратова	Физика
Калинина	Математика
Ягодин	Информатика
Кузнецов	Информатика
Волковец	Информатика
Якубович	Информатика
Олешко	Информатика
Белоус	Информатика
Дружинина	Информатика
Гладкова	Информатика
Вартанов	Математика
Дадаян	Физика
Прохоров	Информатика
Сметкин	Информатика
Пипульгин	Информатика
Бразина	Информатика
Чередниченко	Информатика
Семенюк	Информатика
Чижиков	Информатика
Ляхова	Информатика
Любимова	Информатика
Виноградов	Информатика
Малинкин	Физика
Никитина	Информатика
Мотов	Информатика
Серебренникова	Информатика
Чулкова	Физика
Семёнов	Физика
Сидоров	Информатика
Сергеевич	Физика
Станков	Информатика
Сазонова	Информатика
Попов	Информатика
Волкова	Информатика
Гиниятуллин	Информатика
Черепенко	Информатика
Смирнов	Информатика
Амзаев	Информатика
Максименко	Физика
Стрельцов	Информатика
Лёвина	Информатика
Губичев	Физика
Васина	Информатика
Некрасова	Информатика
Давыдов	Математика
Вадишев	Информатика
Набегаев	Информатика
Сочивко	Информатика
Андреев	Физика
Качурина	Информатика
Арману	Информатика
Викторович	Информатика
Куприенко	Информатика
Александрова	Информатика
Ксюшина	Информатика
Клепикова	Информатика
Климичева	Математика
Осьмак	Информатика
Добровольский	Математика
Поскрякова	Математика
Поскряков	Физика
Алексеева	Информатика
Остряков	Информатика
Власова	Информатика
Спартаков	Информатика
Михайловская	Математика
Тарасов	Информатика
Беляковский	Информатика
Демидов	Информатика
Шалыт	Информатика
Ноженко	Информатика
Копылова	Математика
Алешина	Информатика
Юшина	Информатика
Ляховненко	Информатика
Васильев	Информатика
Чистяков	Информатика
Глотко	Информатика
Бандин	Физика
Щербаков	Информатика
Шифрина	Информатика
Кириллов	Информатика
Михайлова	Информатика
Галанов	Информатика
Гречишкин	Информатика
Батхина	Физика
Трутнев	Информатика
Паразян	Информатика
Криденер	Математика
Ермолаев	Физика
Бухтияров	Информатика
Востриков	Информатика
В-Ва	Математика
Лобакова	Информатика
Мишина	Информатика
Кузнецов	Информатика
Андреева	Информатика
Румянцев	Информатика
Стасюк	Информатика
Сотников	Информатика
Останина	Информатика
Голикова	Информатика
Ястребова	Информатика
Мороз	Математика
Смирнова	Информатика
Абайдулова	Информатика
Донцова	Информатика
Трушкова	Информатика
Вихрова	Информатика
Панова	Информатика
Назаренко	Математика
Бакулева-Морозова	Информатика
Абрамова	Информатика
Фёдоров	Информатика
Бородулина	Математика
Романов	Информатика
Будзович	Информатика
Иванова	Информатика
Рыбин	Информатика
Галкина	Информатика
Леонидович	Математика
Кобылкина	Математика
Яшина	Информатика
Лунькова	Математика
Челидзе	Информатика
Пономаренко	Информатика
Козырев	Информатика
Халимов	Информатика
Ефремова	Физика
Орлов	Информатика
Прамская	Физика
Злодейкина	Физика
Архипов	Информатика
Зотеев	Информатика
Логачев	Информатика
Макушина	Информатика
Ратников	Информатика
Байда	Информатика
Голынский	Информатика
Щевелёв	Информатика
Богомолец	Физика
Палкин	Физика
Ахмадщина	Информатика
Чапчиков	Информатика
Блюмфельдт	Информатика
Сетракова	Информатика
Мишустина	Физика
Лебедев	Математика
Даниелян	Физика
Радченко	Информатика
Зассеев	Информатика
Антия	Физика
Калко	Информатика
Елистратова	Физика
Таранова	Информатика
Суев	Математика
Чижова	Информатика
Петровна	Информатика
Турунцева	Информатика
Туркина	Информатика
Обиденко	Информатика
Дудина	Информатика
Духно	Информатика
Шестакова	Информатика
Даниленко	Информатика
Гетман	Информатика
Егорова	Информатика
Чайкина	Информатика
Беспалов	Информатика
Смирнов	Информатика
Большакова	Математика
Лукьянец	Информатика
Куранов	Информатика
Никулина	Информатика
Решетникова	Информатика
Григорьева	Физика
Волобуева	Физика
Черненко	Математика
Мурашкин	Информатика
Храмцов	Информатика
Карпова	Информатика
Ящук	Информатика
Смирнова	Информатика
Часнык	Физика
Прокофьев	Информатика
Малик	Информатика
Прудывус	Физика
Бочарова	Информатика
Толоконин	Информатика
Богданова	Математика
Леонтьев	Информатика
Волков	Математика
Горнизов	Информатика
Пчелинцев	Физика
Тараненко	Информатика
Охват	Информатика
Лебедев	Физика
Иванов	Информатика
Чернова	Информатика
Антонова	Информатика
